11111111111111111111111111
1E010000000C00000000000001
11000111110000P00000000001
1C00110100C000000000000C01
11000000000000000C00000001
11111111111111111111111111