11111111111111
100P00000000C1
11111111111111