11111111111111
100P0000000EC1
11111111111111