11111111111111
10000000000EC1
11111111111111